xxxxxxxxxxxxxxxxx
x...............x
xc.............ex
xxs....xsx.c..xxx
xxxxx...x...x...x
x....x.........cx
xc....x....c...xx
x..s....xxxss.pxx
xxxxxxxxxxxxxxxxx