xxxxxxxxxxxxxxx
x.............x
x............ex
x..s..c.s.cccxx
x.xxxxxxxxxxxxx
x.....c.......x
xx......c.....x
xx..ss..ssx...x
xxxxxxxxxx...xx
xc..........xcx
x......x......x
xs..x...xxxxxxx
xx...x.......cx
x.x...xxxxx...x
xc..x.....cs.px
xxxxxxxxxxxxxxx