xxxxxxxxxxx
x...x.....x
x......c..x
xe..c.xx..x
xxc.x.....x
x....x....x
x.......s.x
xsssxp.xxsx
xxxxxxxxxxx